1110111101
0010010111
1011110010
1100000011
0101111001
0100001001
0111111001
1100100111
1000101101
1110111001